
1) Посмотреть где я	-pwd
2) Создать папку  	-mkdir foldername
3) Зайти в папку	-cd foldername

4) Создать 3 папки	-mkdir test1, test2, test3   <=============== зачем тут запятые? у вас первые две папки создаются с названием вроде "test1,"

5) Зайти в любоую папку	-cd test1/ <=======   зачем тут / ? команда и без него отработает

6) Создать 5 файлов (3 txt, 2 json)	-touch text1.txt, text2.txt, text3.txt, testjson1.json, testjson2.json <=============== та же история с запятыми. Вы должны просто перечислить названия через пробел, без точек, запятых.  Запятые можно использовать, но тогда перечень файлов заключается в {}

7) Создать 3 папки	-mkdir subtest1, subtest2, subtest3 <======= снова запятые

8. Вывести список содержимого папки	-ls -la
9) + Открыть любой txt файл	-cat text1.txt
10) + написать туда что-нибудь, любой текст.	-cat >> text1.txt (Далее после открытия) New line 
11) + сохранить и выйти.	(CTRL+C для закрытия и сохранения
12) Выйти из папки на уровень выше -cd ..
—
13) переместить любые 2 файла, которые вы создали, в любую другую папку.	-mv test1/text1.txt test1/text2.txt test2/
14) скопировать любые 2 файла, которые вы создали, в любую другую папку.	-cp test2/text1.txt test2/text2.txt test3/
15) Найти файл по имени	-find .(либо каталог в котором искать) -name NAME


16) просмотреть содержимое в реальном времени 
(команда grep) изучите как она работает.	
- grep partofmessage filename.file    <========================  а команда сработает, если вы в указанный файл, например, добавите пару строк? Она в режиме рпеального времени отобразит их?


17) вывести несколько первых строк из текстового файла	-HEAD -3 filename
18) вывести несколько последних строк из текстового файла	-tail -2 filename

19) просмотреть содержимое длинного файла (команда less) 
изучите как она работает.	-(очень разнообразный инструментал для постраничного просмотра с множеством горячих клавиш)         <============   попробуйте наполнить любой файл содержимым и применить к нему команду less. И не забудьте посмотреть, как из нее выходить :)

20) вывести дату и время	-date
=========

Задание *
1) Отправить http запрос на сервер.
http://162.55.220.72:5005/terminal-hw-request	-curl 'http://162.55.220.72:5005/terminal-hw-request'    <=============== там, кстати, в ответе на запрос есть второе задание. Можно попробовать сделать и его